OOOOOOOOOOOOOOOOOOOO
OOOOOOOOOOOOOOOOOOOO
OOOOOOOOOOOOOOOOOOOO
OOOOOOOOO#O##OOOOOOO
OOOOOOOOO#O##OOOOOOO
OOOOOOOOO#O##OOOOOOO
OOOOOOOOO#O##OOOOOOO
OOOOOOOOO#O##OOOOOOO
OOOOOOOOO#O##OOOOOOO
OSOOOOOOO#O##OOOOOOE
OOOOOOOOO#O##OOOOOOO
OOOOOOOOO#O##OOOOOOO
OOOOOOOOO#O##OOOOOOO
OOOOOOOOO#O##OOOOOOO
OOOOOOOOO#O##OOOOOOO
OOOOOOOOO#O##OOOOOOO
OOOOOOOOOOOOOOOOOOOO
OOOOOOOOOOOOOOOOOOOO
OOOOOOOOOOOOOOOOOOOO
OOOOOOOOOOOOOOOOOOOO