SOOOOOOOOOOOOOOOOOOO
OOOOOOOOOOOOOOOOOOOO
OOOOOOOOOOOOOOOOOOOO
OOO###OOOOOOOOOOOOOO
OOO###OOOOOOOO#OOOOO
OOO###OOOOOOOO#OOOOO
OOOO##OOOOOOOO#OOOOO
OOOOOOOOOOOOOO#OOOOO
OOOOOOOOOOOOOO#OOOOO
OOOOOO#########OOOOO
OOOOO##OOOOOOOOOOOOO
OOOOO#OOOOOOOOOOOOOO
OOOOO#OOOOOOOOOOOOOO
OOOOO#OOOOOO########
OOO###OOOOOO#OOOOOOO
OOOOOOOOOOOO#OOOOOOO
OOOOOOOOOOOO#OOOOOOO
OOOOO########OOOOOOO
OOOOOOOOOOOOOOOOOOOO
OOOOOOOOOOOOOOEOOOOO