SOOOOOOOOOOOOOOOOOOO
OOOOOOOOOOOOOOOOOOOO
OOOOOOOOOOOOOOOOOOOO
OOO###OOOOOOOOOOOOOO
OOO###OOOOOOOO#OOOOO
OOO###OOOOOOOO#OOOOO
OOOO##OOOOOOOO#OOOOO
OOOOOOOOOOOOOO#OOOOO
OOOOOOOOOOOOOO#OOOOO
OOOOOOOOO######OOOOO
OOOOO##OOOOOOOOOOOOO
OOOOO#OOOOOOOOOOOOOO
OOOOO#OOOOOOOOOOOOOO
OOOOO#OOOOOOOOOOOOOO
OOO###OOOOOOOOOOOOOO
OOOOOOOOOOOO#OOOOOOO
OOOOOOOOOOOO#OOOOOOO
OOOOO########OOOOOOO
OOOOOOOOOOOOOOOOOOOO
OOOOOOOOOOOOOOEOOOOO